3,2,1,6,3,3,6,3,3,2,1,4,3
8,6,7,5,6,4,5,1,7,7,7,7,1
3,7,1,5,3,3,3,7,6,8,6,1,2
3,0,3,1,6,6,6,3,0,7,5,1,3
5,8,1,7,2,1,2,7,4,4,7,7,5
2,6,2,4,4,0,1,3,4,6,6,5,4
2,2,1,4,4,0,1,8,1,1,1,8,6
8,6,6,3,1,7,0,0,8,3,5,8,4
6,8,2,2,2,7,0,5,4,5,7,0,0
3,1,0,2,1,7,4,4,2,6,3,5,5
1,7,1,6,0,6,8,1,5,8,7,5,5
4,2,3,4,7,3,8,3,0,7,2,3,4
1,7,1,7,6,0,3,6,4,5,2,5,2
6,4,8,2,7,1,3,1,2,0,0,8,4
4,3,4,8,4,1,1,4,8,7,0,0,4