2,5,8,6,6,5,0,2,1,2,6,6,2
1,0,0,1,0,4,4,2,2,0,5,1,0
3,8,1,6,7,6,5,5,5,0,5,1,1
7,0,2,6,8,8,3,8,1,1,2,2,4
5,5,8,8,8,5,7,2,7,3,7,3,5
1,5,4,8,0,3,5,0,6,8,8,5,5
8,3,7,3,5,6,6,0,3,8,0,7,2
3,6,2,8,0,7,1,6,8,8,7,7,3
4,0,4,5,3,1,1,4,4,1,2,4,5
8,4,7,2,5,5,1,6,7,0,0,1,1
7,3,4,4,0,7,0,7,1,7,0,4,8
3,3,2,3,4,5,5,2,6,2,2,7,2
4,2,6,4,3,5,0,3,6,6,0,8,7
2,3,3,6,8,8,2,0,8,8,1,6,1
7,8,5,7,5,0,0,0,8,6,2,6,5