5,7,4,0,3,7,3,3,0,3,5,1,3
3,7,0,0,7,6,2,6,6,8,2,3,2
3,2,7,7,1,3,5,0,0,7,5,8,6
0,6,8,8,7,7,7,2,8,6,4,8,4
8,8,2,0,8,6,2,4,5,6,8,6,7
6,5,5,1,8,1,0,1,5,8,0,2,7
1,2,4,6,3,4,2,0,0,8,4,7,6
1,2,7,0,4,5,5,7,7,6,2,4,6
1,4,5,5,6,8,8,8,4,5,3,2,1
6,0,4,0,7,6,1,0,0,6,1,2,3
3,5,7,1,0,4,2,7,0,5,5,2,7
1,8,4,0,8,6,2,7,6,7,1,2,6
6,3,0,3,6,7,7,4,8,7,6,5,5
0,6,4,5,5,5,0,1,4,4,4,5,3
2,6,5,2,1,1,3,1,7,4,8,8,0