2,6,3,4,4,5,7,5,6,5,3,5,6
6,3,1,8,6,4,3,7,2,2,6,2,0
3,5,6,8,1,2,5,5,2,8,3,3,4
1,3,1,5,8,0,4,4,1,1,1,3,1
3,1,7,8,0,3,8,6,3,5,3,8,4
8,8,3,7,4,6,3,3,1,3,4,8,2
5,4,5,3,8,6,6,3,7,1,1,1,5
5,7,4,0,5,7,7,6,5,7,4,2,7
5,0,5,2,6,8,7,1,7,0,6,7,4
2,8,5,7,7,7,0,4,7,4,8,8,3
5,2,6,4,4,6,0,7,6,0,7,8,2
8,4,2,5,4,0,8,0,5,0,0,2,0
1,6,3,4,8,1,8,3,1,5,0,5,7
0,6,1,7,1,1,5,3,2,7,5,6,5
7,1,3,8,2,1,2,7,3,8,3,3,6