2,2,4,8,5,0,7,8,8,0,5,4,4
6,3,1,8,3,8,3,0,7,2,7,8,5
6,0,1,6,2,8,6,2,2,0,3,4,4
6,5,6,6,5,2,6,5,7,3,5,5,6
5,8,5,4,5,1,3,5,2,3,6,2,2
7,5,0,0,5,3,4,8,6,8,4,7,7
7,3,7,0,2,7,2,1,3,3,3,3,3
6,4,0,0,4,7,4,8,3,1,0,6,3
2,5,5,7,3,3,4,2,4,5,3,2,3
4,8,8,0,3,6,2,7,1,2,7,7,7
3,0,7,0,3,0,1,6,0,2,0,0,6
5,3,4,8,4,8,8,1,4,2,6,3,5
3,2,5,6,2,3,0,7,5,6,3,5,2
6,5,6,2,7,1,5,7,5,6,2,1,1
1,1,6,5,2,2,8,5,6,5,4,3,1