2,7,3,1,3,3,8,2,7,1,0,1,7
7,5,5,2,1,4,2,4,5,2,6,8,2
3,0,7,1,5,8,2,2,8,8,1,2,6
7,1,3,4,3,4,1,1,6,7,6,5,1
2,5,7,6,8,2,4,8,1,7,4,8,6
6,6,0,7,8,5,2,2,2,6,4,7,8
5,3,8,7,2,3,7,6,4,7,7,0,3
3,5,0,3,5,8,1,4,2,2,6,2,7
4,7,8,1,3,3,8,2,4,8,1,7,6
1,0,7,3,5,2,1,3,6,0,4,2,0
5,4,7,7,0,8,3,6,7,5,4,3,5
4,5,2,5,6,0,2,6,3,0,6,1,2
7,1,1,8,5,3,0,7,7,3,6,8,1
8,1,3,3,1,7,4,7,0,6,5,1,3
2,4,6,8,7,8,5,2,4,8,4,1,6