9,1,0,2,6,0,0,1,5,9,1,3,8
9,7,5,6,1,5,8,6,1,1,7,0,0
3,4,0,7,2,8,1,2,5,3,8,1,9
9,1,9,9,3,5,1,1,4,8,2,4,3
3,4,7,7,3,6,0,7,4,6,2,7,4
9,7,7,5,6,8,1,0,2,8,6,9,2
3,4,9,2,5,6,1,8,4,1,3,4,1
4,3,1,0,9,3,5,1,6,6,3,1,5
3,8,8,9,9,7,5,4,0,6,6,9,9
9,7,1,8,6,3,7,8,7,5,0,0,4
4,3,5,6,4,9,9,5,2,8,1,4,9
3,7,0,8,8,1,2,7,4,7,6,2,6
0,4,2,4,4,7,3,8,9,8,8,2,9
6,3,3,7,3,4,7,5,3,4,6,2,1
3,4,4,2,6,2,3,4,7,7,8,8,9