7,6,4,7,5,2,8,4,2,4,1,3,8
7,2,7,2,2,0,4,8,7,4,5,0,2
0,6,4,1,0,4,5,7,0,0,4,2,1
4,4,0,1,7,3,2,0,4,4,1,0,3
1,8,4,8,3,2,0,1,0,0,1,2,3
2,6,8,4,2,1,2,1,7,2,8,1,3
2,3,2,4,4,5,7,1,3,3,4,8,0
1,0,2,8,0,8,1,0,6,8,2,8,7
3,7,2,6,0,4,0,7,7,0,2,6,7
8,1,8,8,7,2,8,7,4,0,5,1,2
1,2,0,5,4,8,5,8,5,3,7,6,8
4,5,4,6,8,2,0,0,6,4,1,8,2
8,1,6,6,7,7,3,0,5,8,6,5,3
4,4,3,5,7,0,3,6,1,5,7,7,5
4,6,2,4,8,0,4,1,0,0,4,2,8