7,2,8,8,8,8,5,4,8,0,8,6,3
6,4,3,0,4,3,1,6,3,6,4,5,7
6,0,5,3,1,0,7,8,1,3,0,3,3
1,2,1,0,6,1,3,1,0,1,1,5,2
7,5,5,3,7,1,6,7,3,0,8,4,0
2,7,6,1,4,8,5,0,4,1,7,8,8
7,3,2,6,5,7,4,5,6,4,2,6,4
6,7,5,1,0,5,8,7,3,4,6,1,7
3,3,6,6,5,0,2,5,3,6,5,0,3
8,3,7,0,3,6,8,4,8,6,2,1,8
0,1,8,2,7,0,4,8,6,4,8,4,0
4,8,7,7,0,8,4,3,6,1,5,8,1
0,6,8,8,8,2,6,1,1,7,2,3,2
8,0,0,3,5,3,1,3,6,4,1,3,2
6,4,7,7,3,8,7,3,5,6,2,8,7