4,4,9,9,9,7,3,0,4,8,3,2,9
4,8,5,3,9,5,8,3,5,5,4,8,5
2,2,3,8,6,7,1,7,7,8,5,9,1
3,9,4,5,5,9,2,0,7,9,3,3,0
7,6,6,6,5,8,4,0,0,7,1,3,5
7,9,6,6,3,3,4,8,6,0,0,5,2
4,6,5,5,7,4,8,8,4,0,2,6,6
1,9,1,5,9,2,6,6,1,4,8,8,6
1,8,4,5,5,1,8,7,5,6,7,1,6
9,5,0,4,4,2,6,5,6,6,3,5,5
2,0,7,1,6,7,0,3,3,5,5,0,7
1,0,8,0,0,6,6,4,8,4,2,2,1
0,6,7,1,8,1,7,9,6,1,1,4,9
9,2,3,0,2,2,5,7,2,7,8,9,2
8,8,9,6,6,8,1,6,1,0,3,8,7