4,0,1,4,8,0,5,8,8,7,0,1,6
0,1,5,1,6,6,7,3,5,5,5,3,7
3,8,3,8,8,8,8,8,1,4,5,8,6
8,1,3,2,2,6,1,2,6,5,2,2,0
8,3,3,1,1,4,3,6,3,7,0,0,6
2,8,8,5,1,0,6,4,5,0,4,5,3
0,7,8,3,6,4,5,0,7,1,7,4,3
5,3,8,1,8,5,0,6,7,6,4,8,6
1,4,6,1,8,0,3,1,1,0,7,5,8
7,5,2,0,4,5,4,4,6,7,7,5,0
1,3,0,2,3,1,0,6,2,2,6,3,1
8,5,4,6,2,7,6,6,7,6,6,5,0
4,7,8,6,5,2,0,1,2,8,7,5,0
2,0,4,2,6,4,3,4,2,4,7,7,0
8,4,1,6,6,5,5,7,3,1,2,0,6