0,0,3,6,5,9,1,9,4,4,7,2,3
8,5,8,9,9,1,5,7,2,5,9,7,3
7,1,0,6,2,5,3,5,9,4,4,3,4
8,1,9,7,1,2,5,2,6,7,7,6,6
5,7,8,2,7,0,4,7,8,8,9,3,8
6,2,5,9,9,8,6,1,1,2,0,1,1
5,1,7,2,1,8,5,7,4,6,6,7,5
4,7,0,4,0,9,9,5,9,4,8,4,8
7,4,7,6,7,8,3,1,0,5,0,3,0
4,7,8,7,3,4,4,5,2,5,3,5,1
7,7,9,9,0,2,6,5,4,0,8,8,3
8,2,9,5,6,4,2,9,3,1,7,2,4
3,2,3,5,4,9,0,1,1,4,2,1,7
3,1,4,1,2,7,5,5,7,2,4,5,4
2,6,6,9,2,0,4,7,1,6,6,5,2