0,9,3,3,0,6,1,1,7,3,2,9,7
1,2,2,6,0,1,6,1,2,0,0,3,9
8,9,4,6,8,9,6,0,0,8,0,9,3
7,6,0,6,1,5,1,1,9,8,5,6,5
3,4,8,9,0,3,2,8,3,9,1,4,0
6,7,4,6,8,4,9,8,5,7,1,2,2
3,3,9,9,4,0,2,9,1,6,1,7,6
7,7,9,8,3,3,1,5,0,8,8,9,1
9,7,3,7,0,5,2,5,9,2,4,1,4
2,4,5,8,6,1,6,7,7,3,6,2,6
1,1,8,0,4,6,2,0,0,2,4,4,7
6,2,2,5,1,6,8,0,4,3,6,1,6
0,4,8,5,7,3,2,5,4,4,4,6,9
0,6,4,6,9,5,3,1,3,1,9,7,3
2,5,0,9,8,0,9,3,5,4,2,6,3