0,5,0,4,4,1,7,1,7,1,3,6,1
5,6,0,3,1,0,0,2,4,2,8,1,3
5,5,4,1,2,8,1,1,5,6,4,5,8
6,0,5,2,0,4,3,6,8,0,7,7,4
1,7,5,8,0,5,6,3,5,3,5,8,6
6,4,5,1,5,4,7,1,8,4,7,2,2
8,3,7,6,1,6,0,2,2,5,4,0,5
5,2,4,5,0,8,6,1,5,6,6,6,8
5,8,4,8,8,4,5,6,8,7,6,3,1
7,3,5,8,5,6,6,6,2,8,0,7,5
2,2,5,0,3,4,8,8,6,8,6,7,5
7,5,0,0,7,7,6,1,5,5,3,0,8
4,8,1,1,8,0,1,0,8,5,6,1,7
2,0,1,7,4,5,6,0,7,7,7,8,4
4,4,6,2,6,3,5,6,3,1,1,0,8