4,7,9,3,5,4,2,2,5,4,5,2,4
4,3,6,6,5,7,4,7,7,3,8,5,6
4,3,5,0,7,2,7,9,8,7,0,0,9
5,5,5,9,9,4,9,3,7,5,8,7,1
2,9,5,8,6,7,1,6,5,6,1,8,8
9,1,1,6,9,8,3,3,9,0,8,7,0
8,4,9,4,4,3,5,0,6,7,3,8,6
4,0,8,6,3,0,2,1,0,5,5,8,6
6,7,9,6,2,7,4,8,1,4,3,3,9
3,0,5,2,8,5,4,0,8,0,2,4,5
7,0,8,3,0,7,1,4,8,3,2,9,2
2,2,3,1,2,4,0,0,9,4,0,7,8
5,5,3,3,4,4,9,3,0,9,7,6,2
5,6,2,1,2,0,9,9,8,4,2,5,7
7,9,8,3,9,2,1,4,7,8,0,4,0