4,3,5,0,1,1,7,6,5,8,8,2,7
2,7,0,4,3,7,8,8,0,1,1,5,3
1,4,7,8,0,2,8,1,7,2,8,5,8
6,2,3,8,2,6,5,3,4,2,5,1,8
1,3,8,2,5,0,3,2,6,0,6,8,1
4,0,4,6,6,8,1,7,3,4,1,7,1
8,7,4,6,7,2,1,4,0,5,1,3,1
6,4,4,3,0,7,2,7,5,2,5,3,5
2,7,8,4,5,2,6,1,0,6,0,2,5
0,4,2,7,5,4,0,3,3,6,7,3,4
6,5,4,3,5,8,4,2,3,3,3,5,4
7,5,4,5,7,3,0,0,6,4,1,8,8
3,8,8,0,0,4,7,3,1,8,2,1,3
6,6,4,0,8,8,6,5,0,2,6,4,6
7,4,1,5,2,1,7,4,3,5,2,0,5