5,8,6,4,2,8,1,8,4,7,0,2,0
3,0,8,6,8,3,7,3,0,4,5,0,5
6,9,8,6,0,8,0,3,3,3,3,5,5
2,6,5,9,9,1,5,4,1,1,5,1,0
4,8,5,0,9,4,7,1,2,8,4,5,0
5,8,1,3,8,7,5,9,1,0,8,0,7
4,4,8,1,3,0,2,7,9,4,6,0,5
3,0,7,1,2,5,6,2,1,1,7,4,7
4,9,7,5,4,2,3,5,5,9,8,5,9
3,6,3,1,0,0,3,0,9,2,7,2,7
1,9,8,2,7,5,6,1,8,3,8,8,6
0,0,6,6,3,4,1,0,2,9,6,6,1
3,2,6,1,5,3,7,5,9,5,7,3,7
2,0,4,4,2,6,8,2,7,9,0,5,8
8,8,9,4,7,1,9,3,5,8,9,4,9