4,2,2,6,8,7,8,0,6,6,2,8,9
6,4,6,3,0,1,5,3,3,4,2,8,7
2,1,2,9,4,3,4,1,6,6,4,9,2
0,5,2,1,5,4,7,6,5,1,9,8,2
9,5,9,1,6,6,8,8,9,3,8,6,4
5,4,1,4,1,4,2,2,7,7,0,0,6
0,7,3,7,4,5,2,3,4,1,3,4,0
5,0,7,5,0,2,7,3,3,1,0,2,9
5,3,0,7,7,5,3,4,1,2,8,6,8
8,8,9,3,3,7,8,8,2,7,3,3,8
5,3,1,9,8,5,6,7,4,1,4,1,6
4,9,2,6,8,9,4,2,0,5,6,5,9
7,2,6,1,7,2,2,0,9,5,7,3,0
0,2,5,0,9,5,2,1,3,2,0,5,6
6,9,5,2,0,5,7,3,4,0,4,4,1