7,9,3,2,9,5,3,7,3,4,4,5,1
2,7,3,2,9,7,3,5,0,9,6,5,6
6,1,5,6,5,0,5,2,8,9,1,1,1
0,8,5,1,1,3,6,5,9,3,6,7,1
6,2,9,4,7,5,7,2,2,4,4,7,1
3,0,3,8,3,3,7,0,1,4,2,3,0
2,0,4,3,2,3,0,0,0,2,3,6,2
8,9,1,0,5,7,6,4,1,0,9,3,2
6,5,4,3,2,8,9,7,6,4,1,1,6
1,2,4,6,6,7,0,9,1,5,1,0,4
4,9,9,4,5,4,5,7,4,9,0,7,5
8,7,4,2,8,7,8,8,5,8,9,2,8
0,1,9,7,1,2,3,4,7,0,1,2,7
3,4,0,7,6,0,5,6,3,3,7,8,5
5,4,0,2,3,1,4,6,7,0,1,9,7