3,7,9,7,1,9,1,2,9,6,8,4,0
9,1,4,2,3,0,6,1,6,2,8,4,7
3,7,7,4,0,0,8,1,2,6,1,0,2
9,4,3,7,6,1,0,2,1,6,9,9,8
8,7,8,4,8,2,8,9,5,1,1,9,0
9,2,6,9,1,7,4,4,2,6,5,3,8
9,9,8,8,1,6,3,0,6,8,1,4,1
4,2,2,3,5,4,6,7,9,6,0,6,0
0,6,0,6,0,7,1,8,2,9,2,6,1
1,6,0,0,6,5,0,6,2,1,6,9,8
1,9,6,6,2,3,4,9,7,4,4,4,2
8,4,7,3,3,7,7,6,3,0,9,4,2
8,3,2,1,9,2,8,5,5,7,1,0,9
7,5,5,8,0,1,4,5,9,2,3,7,2
5,8,5,3,4,9,2,9,1,0,5,0,5