2,2,2,4,9,8,6,8,4,0,3,2,5
4,7,5,1,3,1,6,2,5,6,9,9,7
7,5,2,3,4,3,6,7,0,4,0,9,8
4,2,1,7,2,3,0,0,3,1,6,3,6
8,3,2,2,5,6,3,3,1,1,7,8,5
2,4,8,3,6,7,6,9,2,5,8,5,0
9,6,2,8,5,5,1,7,3,6,9,7,5
3,5,2,2,5,4,1,2,7,3,4,1,7
9,5,1,2,7,9,0,6,4,5,0,7,1
3,7,6,8,3,3,7,9,8,3,6,4,1
4,4,6,8,6,9,8,2,9,0,8,3,5
5,6,7,8,5,6,9,1,9,3,0,9,7
4,8,5,8,4,8,8,2,4,7,2,9,4
9,9,4,2,3,1,3,6,6,2,7,5,7
0,5,7,2,8,4,4,9,0,0,0,0,0