5,1,4,3,4,3,7,7,8,8,7,3,5
5,0,2,6,8,5,5,6,7,0,5,6,8
3,7,8,4,7,3,1,5,6,8,6,6,1
2,1,2,0,5,5,8,3,4,7,8,3,8
1,1,6,5,6,3,4,5,4,3,3,3,8
5,1,0,2,7,6,2,5,0,7,8,3,4
0,4,8,1,3,3,0,4,0,8,8,2,5
8,2,8,8,6,5,3,1,8,3,3,0,8
7,2,4,3,1,7,0,5,5,7,0,4,0
0,0,4,6,8,1,5,8,4,8,4,4,6
5,4,5,7,3,1,0,5,7,0,6,2,2
2,0,2,8,2,8,5,0,2,8,3,5,6
7,5,8,4,1,1,5,1,1,8,2,4,0
1,2,6,6,3,5,1,7,0,1,4,1,1
5,6,8,5,1,7,6,3,1,8,6,2,2