2,7,0,0,1,2,3,1,0,2,5,3,3
3,5,7,0,5,7,3,5,5,5,4,5,0
1,1,5,0,2,1,3,5,3,4,2,7,5
7,2,3,7,6,4,1,3,3,3,7,7,7
5,2,1,0,6,6,3,5,0,5,7,4,4
6,4,1,5,0,4,1,8,7,6,3,8,5
1,4,3,8,3,7,0,7,6,6,7,3,7
2,0,6,7,5,7,0,6,6,6,3,4,8
0,4,7,0,5,7,1,8,0,1,1,8,6
4,3,5,4,6,1,0,7,1,7,5,6,2
0,7,1,1,3,4,2,2,5,6,5,7,2
1,5,3,0,7,4,3,8,1,2,3,8,5
1,4,8,8,5,4,2,4,5,7,4,2,5
6,0,7,7,7,2,0,5,8,1,7,7,6
7,2,1,6,7,0,1,8,7,7,4,2,0