9,6,0,1,4,1,0,3,6,6,2,0,0
7,8,1,6,7,3,1,1,2,7,2,7,0
0,6,5,2,4,3,6,6,2,8,7,7,8
4,4,5,2,9,8,7,3,2,5,5,0,5
0,4,7,2,8,4,2,1,2,8,2,7,6
5,4,1,5,2,2,0,6,2,3,3,8,4
7,4,1,7,8,8,8,6,0,4,6,6,6
9,2,2,5,5,9,8,8,6,2,8,4,3
3,8,0,9,4,6,5,7,9,0,0,2,8
0,0,5,6,1,7,5,4,2,2,7,9,7
1,1,5,5,7,9,6,9,4,6,4,1,3
6,0,6,9,8,7,4,0,0,9,1,1,7
1,1,9,5,2,6,6,2,2,3,5,1,7
1,4,7,4,4,0,8,9,0,7,3,9,5
3,8,3,1,2,1,4,7,0,3,7,0,0