4,4,6,1,4,8,4,8,3,7,1,3,3
0,6,1,0,2,8,3,0,4,4,0,1,6
5,4,8,0,2,1,1,5,2,1,2,1,1
0,5,2,0,6,1,4,1,6,2,4,1,7
2,6,7,4,7,0,8,6,3,4,4,6,1
4,5,8,3,6,8,1,4,6,5,1,2,3
6,4,1,5,7,6,0,6,1,5,7,1,1
0,6,5,4,0,3,2,1,4,0,1,2,8
0,5,8,4,6,2,7,1,7,3,1,2,3
1,7,2,2,8,4,5,0,0,4,8,3,7
3,5,5,2,0,2,6,6,2,2,7,2,2
3,1,5,0,0,5,4,5,0,3,5,2,8
0,8,3,0,6,7,7,3,4,2,1,0,1
8,2,0,3,0,8,0,6,8,4,1,6,1
8,6,6,8,5,2,8,1,3,4,3,0,7