4,6,7,0,0,1,3,6,6,1,3,8,2
3,4,1,0,3,5,6,3,8,4,4,7,0
2,1,6,3,2,6,2,0,8,7,1,4,0
1,5,5,2,0,0,5,4,2,4,1,6,8
7,2,5,3,4,3,6,0,3,5,6,0,2
8,5,6,8,7,7,2,4,7,0,7,4,5
7,7,7,5,8,2,2,7,7,6,5,8,8
4,4,3,2,3,7,4,3,3,0,5,8,7
4,5,6,2,5,5,5,5,0,8,7,5,0
1,4,0,7,4,6,7,2,0,3,4,3,3
7,8,0,5,8,1,3,7,4,5,6,8,4
6,6,5,7,8,7,8,2,2,4,4,5,4
4,2,1,2,6,4,1,1,1,8,2,8,6
5,8,4,3,5,3,8,2,7,5,2,6,1
6,3,0,4,1,7,2,2,8,3,1,1,4