3,1,5,8,1,5,8,9,4,2,5,4,1
8,5,2,3,7,0,1,5,6,9,7,7,6
7,9,0,2,5,0,1,4,7,0,6,5,7
8,1,1,3,6,0,0,5,3,5,9,9,8
5,7,1,8,5,6,4,3,0,4,3,5,4
4,5,0,6,4,6,9,0,2,8,7,1,1
8,5,0,9,1,1,0,5,6,9,8,0,4
6,4,6,6,5,2,9,7,9,3,6,9,3
6,9,8,5,0,3,3,3,3,0,0,2,7
3,3,8,4,2,1,7,7,5,8,4,9,4
9,1,4,7,4,0,8,8,7,8,5,8,1
5,7,4,9,2,1,4,4,8,8,1,0,3
8,8,0,6,1,0,9,8,4,2,3,3,9
5,8,1,5,1,8,5,0,2,6,7,1,2
0,0,1,3,0,6,5,2,3,0,1,6,9