5,4,1,5,0,8,1,6,0,5,8,2,1
3,0,7,4,6,6,6,8,5,5,1,1,4
2,2,3,8,7,0,6,5,7,1,0,6,0
1,7,4,4,3,2,1,4,3,3,2,8,5
1,7,6,2,2,8,2,2,6,3,0,3,5
6,3,1,5,4,5,7,4,1,8,5,6,7
0,3,0,3,0,0,1,1,6,7,5,0,1
6,7,7,3,2,7,3,7,4,3,8,0,4
1,7,2,5,4,6,0,4,8,2,1,6,1
6,8,0,6,1,2,7,3,6,5,6,2,5
2,1,7,7,5,6,7,0,3,2,5,2,1
6,6,4,6,4,7,7,5,4,6,1,3,7
6,3,1,2,0,7,0,6,4,5,4,6,0
4,5,0,5,0,2,8,3,3,4,7,0,2
4,6,4,4,1,7,3,7,2,3,8,0,6