1,8,3,2,8,8,3,7,9,3,4,8,3
1,3,7,3,2,0,8,9,4,6,9,2,5
8,6,3,3,5,4,2,0,9,8,9,9,2
8,2,8,6,0,1,4,2,2,2,6,4,8
5,0,0,5,1,8,3,0,0,3,4,3,6
0,0,0,1,9,7,7,7,6,5,2,2,8
6,2,9,6,0,4,7,5,0,1,6,3,9
7,4,9,8,2,1,7,7,0,0,8,0,5
8,1,4,3,1,0,3,3,7,1,8,9,4
3,5,6,9,3,6,7,0,5,5,6,7,9
3,6,3,0,9,0,4,1,8,0,4,9,3
2,0,9,3,3,9,6,4,9,6,5,4,5
6,9,7,8,5,0,7,4,4,8,7,8,9
6,2,9,2,0,1,1,4,4,4,4,5,9
2,7,1,0,1,1,2,9,9,7,9,7,0