1,9,1,8,3,9,0,7,2,4,3,4,0
8,0,9,2,4,7,0,0,8,4,6,1,9
0,9,8,6,5,2,7,5,5,8,9,6,0
2,1,7,8,3,7,3,5,8,2,8,8,2
7,6,9,8,5,4,4,7,1,7,4,6,7
8,3,8,3,8,0,2,1,4,1,6,8,7
0,1,9,5,6,3,6,7,5,1,0,0,3
8,1,2,0,9,0,5,9,9,3,7,3,0
4,1,1,7,6,1,6,8,7,8,8,3,9
3,4,7,8,4,9,0,4,4,7,5,2,4
3,3,1,3,8,4,2,9,6,4,6,6,7
4,3,3,6,9,5,1,5,0,0,1,5,0
3,3,7,9,0,0,7,6,3,3,7,4,1
7,0,0,0,7,9,7,5,4,2,6,8,9
2,0,2,6,9,5,2,7,5,2,4,2,0