8,6,0,5,7,3,1,8,6,8,5,6,1
4,8,3,2,5,7,3,3,7,6,4,5,2
6,5,0,3,4,0,4,4,7,6,3,4,8
0,1,6,3,8,1,0,7,7,4,1,5,7
5,7,5,1,5,5,4,2,2,4,5,2,6
6,1,4,5,5,1,4,8,8,5,0,5,0
4,0,1,0,4,7,6,3,4,3,7,8,0
7,2,0,6,4,5,0,4,7,7,1,5,0
5,8,7,5,3,5,5,7,7,7,0,6,6
6,1,4,7,0,3,2,7,1,6,7,7,2
0,2,0,4,7,0,6,6,5,6,3,8,1
0,3,5,1,3,6,7,8,0,5,0,3,7
7,5,6,3,2,0,0,0,4,6,8,4,0
0,6,6,8,7,3,3,3,6,4,5,2,0
5,7,8,3,8,7,7,8,8,5,0,3,3