4,6,6,5,0,1,4,4,6,7,5,8,0
8,1,8,0,5,4,7,6,2,4,6,4,8
1,7,5,3,2,1,2,0,8,8,7,1,4
5,5,8,2,8,4,1,3,8,5,5,8,8
8,0,1,0,2,7,5,8,5,2,6,4,8
8,8,1,6,5,7,1,2,3,0,1,7,1
1,0,6,0,2,5,8,4,3,7,7,7,4
1,0,8,2,4,4,5,6,3,4,6,1,3
2,1,8,7,2,4,6,2,7,8,2,7,5
7,0,1,0,3,4,8,3,5,7,2,0,6
0,4,4,4,2,4,7,2,1,6,4,5,6
3,3,7,8,1,3,4,4,5,5,5,4,3
1,7,1,8,6,7,1,0,2,6,3,3,4
8,6,6,3,2,5,4,3,2,8,0,7,0
4,0,8,5,4,3,7,6,2,2,2,6,8