0,0,0,0,0,0,0,0,0,0,0,0,0
5,5,5,5,5,5,5,5,5,5,5,5,5
0,0,0,0,0,0,0,0,0,0,0,0,0
9,9,8,8,9,8,8,8,9,8,8,9,9
0,0,0,0,0,0,0,0,0,0,0,0,0
5,5,5,5,5,5,9,5,5,5,5,5,5
6,6,6,6,6,9,6,9,6,6,6,6,6
0,0,0,0,0,0,0,0,0,0,0,0,0
8,8,8,8,8,8,8,8,8,8,8,8,8
0,0,0,9,0,0,0,0,0,9,0,0,0
0,0,0,0,0,0,0,0,0,0,0,0,0
0,0,0,0,0,0,0,0,0,0,0,0,0
4,4,4,4,4,4,4,4,4,4,4,4,4
8,8,8,8,0,0,0,0,0,8,8,8,8
0,0,0,0,8,8,8,8,8,0,0,0,0