3,8,5,0,3,3,5,2,3,8,9,5,5
5,6,6,6,8,3,1,6,6,6,3,6,9
9,9,5,5,6,5,8,8,1,2,4,9,3
1,8,5,0,8,8,5,0,0,9,2,3,2
9,1,8,0,9,5,6,4,7,0,5,2,5
5,6,8,8,3,0,4,1,0,7,1,1,0
3,8,1,3,2,9,6,6,2,2,5,8,6
7,0,4,1,8,3,2,9,9,2,8,8,1
1,2,9,2,3,6,6,7,9,7,9,7,6
5,2,8,6,2,8,3,1,0,5,2,5,8
2,6,8,7,7,3,0,2,3,8,2,1,9
6,9,2,1,6,8,5,3,8,0,1,3,1
8,7,9,4,9,7,3,7,4,9,9,9,9
4,3,3,8,7,8,2,1,7,7,4,6,9
0,9,0,5,2,8,4,3,9,2,8,8,4