4,0,1,1,9,7,0,4,9,8,7,3,5
5,9,8,8,3,8,7,1,4,6,6,2,4
3,8,4,3,8,6,4,6,6,0,0,2,1
2,2,4,1,6,5,1,4,3,7,5,1,0
4,2,7,8,6,5,2,2,0,3,8,6,0
0,8,6,7,1,0,4,2,7,1,0,7,1
3,7,7,0,4,3,6,3,7,2,8,2,7
7,6,0,7,2,1,8,5,8,8,4,6,7
0,0,3,5,2,1,3,5,3,8,2,0,3
5,3,2,1,1,2,8,0,6,3,6,0,2
5,7,6,5,0,1,6,1,8,2,4,1,6
8,0,7,4,0,8,1,2,6,4,7,5,7
2,6,1,0,4,2,8,0,1,5,5,6,5
4,6,5,2,4,2,8,1,7,4,3,2,1
8,7,8,6,8,2,6,1,8,6,7,0,2