9,6,8,2,4,8,3,9,7,5,3,1,9
3,4,1,9,1,2,0,6,9,2,9,7,9
9,8,5,8,0,6,8,3,2,7,9,8,2
4,0,7,0,3,5,1,9,4,1,2,7,1
4,2,9,1,2,3,3,4,9,0,0,7,3
1,3,8,7,6,9,0,7,9,8,6,2,8
8,7,2,3,8,1,8,1,3,2,8,3,5
3,7,7,4,6,7,5,8,3,0,8,8,6
0,7,9,7,9,7,8,9,8,2,2,5,1
9,6,2,6,4,9,9,0,1,9,0,2,2
5,4,4,2,4,2,6,0,5,0,2,6,0
7,7,9,2,1,8,9,0,3,7,0,5,0
7,7,4,4,3,3,8,9,6,0,8,0,6
9,7,5,2,4,4,8,2,4,5,9,6,0
8,8,8,0,1,6,2,3,9,7,4,6,2