9,9,3,2,7,7,5,8,6,6,2,1,5
1,9,1,7,7,9,4,6,0,2,5,0,6
6,7,1,0,5,7,0,4,7,2,8,2,3
9,6,8,9,1,4,2,9,6,5,6,4,8
7,6,1,0,1,6,8,1,6,1,0,7,8
1,9,8,3,3,8,3,7,0,1,0,2,0
6,4,7,3,5,1,7,2,1,0,6,4,7
9,2,6,9,6,7,6,7,1,7,9,3,8
9,5,6,7,4,5,8,7,0,1,6,9,8
5,0,0,3,4,0,0,4,6,3,0,6,3
9,7,1,5,4,7,6,5,1,1,3,4,1
3,4,8,8,5,4,7,4,9,3,2,8,4
2,8,2,6,3,4,5,3,0,0,5,0,5
7,9,3,9,7,9,6,8,2,4,2,8,7
3,4,7,7,6,7,9,3,2,1,9,0,7