7,9,7,4,9,1,6,7,9,3,9,7,3
5,0,2,7,4,5,7,4,4,1,4,7,3
4,0,6,2,4,5,6,6,3,8,4,6,2
3,4,5,3,5,7,7,4,3,4,8,6,5
5,5,1,8,9,3,1,4,9,8,8,9,7
8,7,0,3,7,8,3,7,5,4,2,7,0
5,5,9,2,8,7,6,3,4,8,9,7,6
4,7,3,8,6,9,6,1,5,6,7,5,0
1,0,9,6,7,4,8,7,0,2,2,0,4
2,5,6,4,1,6,0,5,3,1,3,5,4
9,0,6,2,5,4,1,9,8,2,1,7,7
8,7,1,8,9,7,7,9,8,2,4,7,8
1,6,7,4,5,8,5,3,5,7,8,8,3
1,5,5,3,2,7,0,9,0,7,5,7,2
1,2,3,9,2,3,8,3,7,3,2,9,9