8,4,5,3,4,4,6,5,9,4,1,0,4
0,0,9,5,4,6,3,3,0,4,1,9,9
3,5,0,1,3,0,8,3,1,7,7,3,0
1,9,8,2,7,7,0,0,9,8,6,0,7
1,7,1,0,2,3,9,1,0,7,5,0,0
8,2,2,4,2,2,9,2,1,4,4,5,9
8,9,7,4,5,2,2,4,9,3,9,0,7
2,8,1,1,5,6,7,4,7,0,7,2,0
8,1,7,3,0,1,7,0,1,6,3,6,0
3,7,7,6,6,9,8,0,9,4,9,7,8
5,6,7,6,9,3,5,1,7,7,8,2,1
5,7,2,2,6,4,0,7,7,4,1,7,0
3,9,8,9,2,2,0,7,0,2,2,3,2
3,5,6,8,0,6,3,8,7,2,4,2,7
8,1,2,0,6,1,2,3,7,7,9,7,3