3,4,5,0,6,0,2,2,5,4,4,1,3
0,8,1,6,5,2,1,0,7,2,7,0,1
8,7,2,8,2,1,4,3,3,0,1,5,0
5,5,3,7,2,5,5,4,2,1,8,5,6
3,6,6,0,3,1,6,7,4,5,0,5,3
0,0,2,0,6,5,3,2,2,4,7,6,8
6,2,3,3,2,8,1,4,1,5,8,4,2
3,5,4,1,0,8,8,8,1,6,8,6,4
2,8,2,5,8,3,4,1,7,2,8,3,7
1,5,8,7,1,1,7,5,7,5,6,3,6
4,2,4,5,6,3,5,2,0,4,1,6,6
0,4,5,7,5,3,6,0,5,3,3,3,2
3,7,7,5,5,4,4,6,7,6,2,1,4
4,7,6,0,0,5,1,6,8,3,5,7,8
5,2,1,2,2,6,8,3,1,8,3,6,2