6,3,8,8,1,5,5,9,2,7,7,4,9
2,1,7,9,5,5,0,6,6,0,3,8,2
9,7,7,2,6,8,0,0,8,2,0,1,9
3,4,4,7,3,0,6,4,3,0,5,5,7
3,2,8,0,3,5,5,9,5,7,5,0,5
0,7,3,7,1,4,1,6,9,7,9,9,9
5,1,0,7,6,5,7,5,7,7,2,3,3
3,1,9,6,1,3,8,7,0,9,0,1,5
6,4,3,0,9,1,9,5,5,4,9,7,8
8,9,2,0,7,9,2,5,1,3,0,3,7
7,4,4,3,6,7,7,4,2,8,4,5,2
7,5,7,5,4,2,1,5,4,8,6,3,5
0,4,3,5,8,7,8,1,1,2,8,4,5
3,7,6,3,6,2,3,4,0,2,7,3,7
7,8,6,7,1,6,2,2,0,0,8,0,5